1111111111111
100000000CCC1
1010011110CC1
1P1D010E00CC1
1111111111111